111111111111111111111111
100000000000000000000001
100000000000111111100001
100000000000000111000001
100001100000000000C00001
1000C11000000000E1000001
100000110000000111000001
100000000000000110000001
10000001000C001100000001
100001110000000000000001
111111111111111111111111