1111111111
100000P001
10E0000001
100P000001
100000C001
1111111111