11111111111
1P1C1000001
10000000001
10000000001
10000000001
11110000001
11E10000001
11111111111