1111111111111111
1000C00000110E01
1011100C01100001
1000000000110C01
10P0011000000001
1111111111111111