11111111111111111
100C0100000000111
10E01100C00000011
10011100000000001
10C0000000000C001
10000000001110001
111P000C001100011
11111111111111111