1111111111111111
10P0C00000100C01
1000100E00000001
1111111111111111