111111111111111111111111
110000000000000000000P01
1000E0000001111110000011
100000000000110000000111
100000000000011110000011
100000000C0001111100C001
100100000000011111000001
100110000000001111000011
100011000000000001000111
110C01100000000111000011
111000100000000100000001
11110000000C0001000C0011
111110000000011111000111
111111000000000000001111
111111111111111111111111