111111111111111111111111
110000000000000000000001
1000C0000001111110000011
100000001111110000000111
100000000C1100000000C001
100110000000000011000011
100011000000000001000111
11000110000C00011100P011
1110E0100000000100000001
1111000000000001000C0011
111111111111111111111111