1111111111
100000P001
10E000D001
1000000001
100000C001
1111111111