1111111111
100000P001
10E0000001
1000000001
100000C001
111111111